id,date,credit,debit,balance
01,14/2/2022,100000,0,300000
02,15/2/2022,100000,0,400000
03,16/2/2022,0,150000,250000
04,17/2/2022,0,50000,200000
05,17/2/2022,0,50000,150000
06,17/2/2022,0,50000,100000
07,17/2/2022,0,50000,50000
